hello=kids.common.controller.HelloController
world=kids.common.controller.WorldController
main=kids.common.controller.MainController
meInsert=kids.board.medicine.controller.InsertMedicineController
meUpdate=kids.board.medicine.controller.UpdateMedicineController
meDelete=kids.board.medicine.controller.DeleteMedicineController
meList=kids.board.medicine.controller.ListMedicineController
meDetail=kids.board.medicine.controller.DetailMedicineController
meCheck=kids.board.medicine.controller.CheckMedicineController
hoInsert=kids.board.re_home.controller.InsertRe_homeController
hoUpdate=kids.board.re_home.controller.UpdateRe_homeController
hoDelete=kids.board.re_home.controller.DeleteRe_homeController
hoList=kids.board.re_home.controller.ListRe_homeController
hoDetail=kids.board.re_home.controller.DetailRe_homeController
hoCheck=kids.board.re_home.controller.CheckRe_homeController
empbInsert=kids.board.emplo_board.controller.InsertEmpBoardController
empbUpdate=kids.board.emplo_board.controller.UpdateEmpBoardController
empbDelete=kids.board.emplo_board.controller.DeleteEmpBoardController
empbList=kids.board.emplo_board.controller.ListEmpBoardController
empbReply=kids.board.emplo_board.controller.ReplyEmpBoardController
planInsert=kids.board.edu_program.controller.InsertEdu_programController
planUpdate=kids.board.edu_program.controller.UpdateEdu_programController
planDelete=kids.board.edu_program.controller.DeleteEdu_programController
planList=kids.board.edu_program.controller.ListEdu_programController
planDetail=kids.board.edu_program.controller.DetailEdu_programController
planCheck=kids.board.edu_program.controller.CheckEdu_programController
timeInsert=kids.board.timetable.controller.InsertTimeTableController
timeUpdate=kids.board.timetable.controller.UpdateTimeTableController
timeDelete=kids.board.timetable.controller.DeleteTimeTableController
timeList=kids.board.timetable.controller.ListTimeTableController
dietInsert=kids.board.diet.controller.InsertDietController
dietUpdate=kids.board.diet.controller.UpdateDietController
dietDelete=kids.board.diet.controller.DeleteDietController
dietList=kids.board.diet.controller.ListDietController
dietDetail=kids.board.diet.controller.DetailDietController
goInsert=kids.board.notice_board.controller.InsertNoticeController
goUpdate=kids.board.notice_board.controller.UpdateNoticeController
goDelete=kids.board.notice_board.controller.DeleteNoticeController
goList=kids.board.notice_board.controller.ListNoticeController
goDetail=kids.board.notice_board.controller.DetailNoticeController
noInsert=kids.board.notification_board.controller.InsertNotification_boardController
noUpdate=kids.board.notification_board.controller.UpdateNotification_boardController
noDelete=kids.board.notification_board.controller.DeleteNotification_boardController
noList=kids.board.notification_board.controller.ListNotification_boardController
acInsert=kids.board.activity.controller.InsertActivityController
acUpdate=kids.board.activity.controller.UpdateActivityController
acDelete=kids.board.activity.controller.DeleteActivityController
acList=kids.board.activity.controller.ListActivityController
acDetail=kids.board.activity.controller.DetailActivityController
accoInsert=kids.board.activity_comment.controller.InsertAcCommentController
accoUpdate=kids.board.activity_comment.controller.UpdateAcCommentController
accoDelete=kids.board.activity_comment.controller.DeleteAcCommentController
accoList=kids.board.activity_comment.controller.ListAcCommentController
accoReply=kids.board.activity_comment.controller.ReplyAcCommentController
stInsert=kids.members.student.controller.InsertStudentController
stUpdate=kids.members.student.controller.UpdateStudentController
stDelete=kids.members.student.controller.DeleteStudentController
stList=kids.members.student.controller.ListStudentController
stDetail=kids.members.student.controller.DetailStudentController
resInsert=kids.management.reservation.controller.InsertReservationController
resUpdate=kids.management.reservation.controller.UpdateResevationController
resDelete=kids.management.reservation.controller.DeleteResevationController
resList=kids.management.reservation.controller.ListResevationController
resDetail=kids.management.reservation.controller.DetailResevationController
myclInsert=kids.management.myclass.controller.InsertMyclassController
myclUpdate=kids.management.myclass.controller.UpdateMyclassController
myclDelete=kids.management.myclass.controller.DeleteMyclassController
myclList=kids.management.myclass.controller.ListMyclassController
suInsert=kids.management.subject.controller.InsertSubjectController
suUpdate=kids.management.subject.controller.UpdateSubjectController
suDelete=kids.management.subject.controller.DeleteSubjectController
suList=kids.management.subject.controller.ListSubjectController
paInsert=kids.members.parents.controller.InsertParentsController
paUpdate=kids.members.parents.controller.UpdateParentsController
paDelete=kids.members.parents.controller.DeleteParentsController
paDetail=kids.members.parents.controller.DetailParentsController
paList=kids.members.parents.controller.ListParentsController
paIdSearch=kids.members.parents.controller.SearchParentsIdController
paPaSearch=kids.members.parents.controller.SearchParentsPasswordController
paStSearch=kids.members.parents.controller.SearchParentsStudentController
paLogin=kids.members.common.controller.LoginParentsController
idCheck=kids.members.common.controller.CheckIdController
logout=kids.members.common.controller.LogoutController
zipSearch=kids.members.common.controller.SearchZipcodeController
updatePassword=kids.members.common.controller.UpdatePasswordController
empLogin=kids.members.common.controller.LoginEmployerController
empInsert=kids.members.employees.controller.InsertEmployerController
empList=kids.members.employees.controller.ListEmployerIdController
empUpdate=kids.members.employees.controller.UpdateEmployerController
empDelete=kids.members.employees.controller.DeleteEmployerController
empDetail=kids.members.employees.controller.DetailEmployerController
empIdSearch=kids.members.employees.controller.SearchEmployerIdController
empPaSearch=kids.members.employees.controller.SearchEmployerPasswordController
empUpPassword=kids.members.common.controller.EmpUpPasswordController
empmOn=kids.management.emp_manage.controller.OnEmployerController
empmOff=kids.management.emp_manage.controller.OffEmployerController
empmUpdate=kids.management.emp_manage.controller.UpdateEmployerManagerController
empmList=kids.management.emp_manage.controller.ListEmployerManagerController
empmDetail=kids.management.emp_manage.controller.DetailEmployerManagementController
empmInsert=kids.management.emp_manage.controller.InsertEmployerManagementController
empmAtt=kids.management.emp_manage.controller.AttEmployerManagementController
stmInsert=kids.management.st_total.st_manage.controller.InsertStudentManagerController
stmUpdate=kids.management.st_total.st_manage.controller.UpdateStudentManagerController
stmDelete=kids.management.st_total.st_manage.controller.DeleteStudentManagerController
stmDetail=kids.management.st_total.st_manage.controller.DetailStudentManagerController
sthwInsert=kids.management.st_total.st_manage.controller.InsertStudentHWController
sthwDetail=kids.management.st_total.st_manage.controller.DetialStudentHWController
sthwUpdate=kids.management.st_total.st_manage.controller.UpdateStudentHWController
sthwDelete=kids.management.st_total.st_manage.controller.DeleteStudentHWController
sthwList=kids.management.st_total.st_manage.controller.ListStudentHWController
stfInsert=kids.management.st_total.stu_fee.controller.InsertStudentFeeController
stfUpdate=kids.management.st_total.stu_fee.controller.UpdateStudentFeeController
stfList=kids.management.st_total.stu_fee.controller.ListStudentFeeController
salInsert=kids.management.sales_table.controller.InsertSalesController
salList=kids.management.sales_table.controller.ListSalesController
salUpdate=kids.management.sales_table.controller.UpdateSalesController
######################추가 todolist##########################
submit=kids.members.common.controller.SubmitController
submitUpdate=kids.members.common.controller.SubmitUpdateController
empJoin=kids.members.employees.controller.EmpJoinController
###테스트중 - 정희###
pidCheck=kids.members.common.controller.CheckPidController
paSubmitUpdate=kids.members.parents.controller.paSubmitUpdateController
changePloginfo=kids.members.parents.controller.paChangeLoginfoController
paUpdateTwo=kids.members.parents.controller.UpdateParentsTwoController
resAfterList=kids.management.reservation.controller.ListReservationAfterController
hoListTwo=kids.board.re_home.controller.ListRe_homeTwoController